NO             textures/mossy_cobblestone.xpm
F 122,90,200
C 99,98,0
SO                       textures/cobblestone.xpm     
                  WE          textures/netherrack.xpm 
EA            textures/cobbled_deepslate.xpm





        1111111111111111111111111
        1000000001100000000000001
        1011000001110000000000001
        1001000000000000000000001   
1111111110110000011100000000000E1     
100000000011000001110111111111111 lololol
11110111111111011100000010001    
1111011111111101110110010001
11000000110101011100000010001
10000000000000001100000010001
10000000000000001101010010001
11000001110101011111011110001 
10000001 10000011100000000001
11111111 1111111 111111111111