
NO             textures-mineraux/rouge-fonce.xpm  
F 11,77,9
C 186,224,243

SO                       textures-mineraux/rose.xpm     
                  WE          textures-mineraux/pierre.xpm 
EA            textures-mineraux/vert-fonce.xpm
        1111111111111111111111111
        1000000001100000000000001
        1011000001110000000000001
        1001000000000000000000001   
111111111011000001110000000000001     
100000000011000001110111111111111     
11110111111111011100000010001    
11110111111111011101010010001
11000000110101011100000010001
10011000000000001100000010001
100000W0000000001101010010001
11010001110101011111011110001 
10000001 10000011100000000001
11111111 1111111 111111111111