NO             text1res-mineraux/rouge-fonce.xpm  
F 11,77,9
C 186,224,243
SO                       text1res-mineraux/rose.xpm     
                  WE          text1res-mineraux/pierre.xpm 
EA            text1res-mineraux/vert-fonce.xpm
                111111
1111111111111111100E1
111111111111111100111
1111011111111111010111
101010000000000000011111
11001110011111111111111
1011111111111
11