
NO             textures-mineraux/rouge-fonce.xpm  
F 11,77,9
C 186,224,243

SO                       textures-mineraux/rose.xpm     
                  WE          textures-mineraux/pierre.xpm 
EA            textures-mineraux/vert-fonce.xpm
        1111111111111111111111111
        1000000001100000000000001
        1011000001110000000000001
        1001000002000000000000001   
111111111011000001110000000000001     
100000000011000001110121111111111     
11110111111111011100000010001    
11112111111111011101010010001
11000000110101011100000010001
10011111000000001100000010001
100002W2000100002101010010001
11010121110101011111011110001 
10000001 10000011100000000001
11111111 1111111 111111111111