
NO             textures-mineraux/rouge-fonce.xpm  
F 11,77,9
C 186,224,243

SO                       textures-mineraux/rose.xpm     
                  WE          textures-mineraux/pierre.xpm 
EA            textures-mineraux/vert-fonce.xpm
1111111111111111111111
1000000000000010000001
1000000000000000000001
111111000S000011100111
1000000000000010000001
1000010000000010000001
1111111111111111111111