
NO             textures-mineraux/rouge-fonce.xpm  
F 122,90,255
C 99,98,0

SO                       textures-mineraux/rose.xpm     
                  WE          textures-mineraux/pierre.xpm 
EA            textures-mineraux/vert-fonce.xpm
111111111111
100S00000001
100000010001
111111111111