NO textures-mineraux/rose.xpm
SO textures-mineraux/pierre.xpm    

 WE textures-mineraux/vert-fonce.xpm

F 0,0,0

C 255,255,255


EA textures-mineraux/wall_lava.xpm

1111111111111111111111111111111111111
1000000000000000000000000000000000001
1000000000000000000000000000111111101
10000000000000000000000000001     101
100000000000000000001000000021    101
10000000000000000001 10000001     101
10000000000000000000100000001     101
10000000000000000000000000001     101
1000000000000000000000000000111111101
10000000000000000000N0000000200000001
1000000000000000000000111111111111111
10000000000000000000001     1
10000000000000000000001     1
11111111111111111111111111111